# eOS Classes
Encoder	KEYWORD1
Wheel	KEYWORD1
Key	KEYWORD1
Submaster	KEYWORD1
Fader	KEYWORD1
Macro	KEYWORD1
OscButton	KEYWORD2

# eOS Class mebers
update	KEYWORD2
button	KEYWORD2
parameter	KEYWORD2
index	KEYWORD2
faderBank	KEYWORD2
faderNumber	KEYWORD2

# eOS Functions
sendOSC	KEYWORD2
filter	KEYWORD2
subscribe	KEYWORD2
unsubscribe	KEYWORD2
ping	KEYWORD2
command	KEYWORD2
newCommand	KEYWORD2
user	KEYWORD2
shiftButton	KEYWORD2
initFaders	KEYWORD2

# eOS enums and constants
HOME	LITERAL1
FINE	LITERAL1
SUBSCRIBE	LITERAL1
UNSUBSCRIBE	LITERAL1
EDGE_DOWN	LITERAL1
EDGE_UP	LITERAL1
FORWARD	LITERAL1
REVERSE	LITERAL1
INT_ACC	LITERAL1
WHEEL_ACC	LITERAL1
FADER_UPDATE_RATE_MS	LITERAL1
THRESHOLD	LITERAL1
